[
  [
    "ACORN",
    "ROMEO",
    "ELECT",
    "NANCE",
    "ASSES"
  ],
  [
    "ACORN",
    "ROMEO",
    "ELECT",
    "NONCE",
    "ARSED"
  ],
  [
    "ACORN",
    "ROMEO",
    "ELECT",
    "NONCE",
    "ARSES"
  ],
  [
    "ACORN",
    "RODEO",
    "ENDED",
    "NIEVE",
    "ACRES"
  ],
  [
    "ADAGE",
    "REBEL",
    "EMBED",
    "NOOSE",
    "ASTER"
  ],
  [
    "AFORE",
    "RELAX",
    "ERICA",
    "NAVEL",
    "ALERT"
  ],
  [
    "AMASS",
    "RADII",
    "ENDED",
    "NIEVE",
    "ACRES"
  ],
  [
    "APPLE",
    "RELAX",
    "ERASE",
    "NICER",
    "ALERT"
  ],
  [
    "APPLE",
    "RELAX",
    "ERASE",
    "NIGER",
    "ALERT"
  ],
  [
    "AROSE",
    "RAVEN",
    "EVERT",
    "NERVE",
    "ALTER"
  ],
  [
    "AROSE",
    "RAVES",
    "EVERT",
    "NERVE",
    "ALTER"
  ],
  [
    "AROSE",
    "RAVEN",
    "EVERT",
    "NERVE",
    "ASTER"
  ],
  [
    "AROSE",
    "RIVEN",
    "EVERT",
    "NERVE",
    "ALTER"
  ]
]